# # . . # # # . # # . # # # # # # . # .
# . . # . # # # . # . # . . . # # # . #
. # . . # . . . . # # . # # # # . # # .
# . . . # . . . . . . . . # # . # # # .
# # . . . . . . . . . . # # # . # . # #
# . . # . # . . # . . # # # # . # . . .
. # . . . . # # . . . . # . # . . # # #
. . # # # # . # # # . . # . . . # # # .
. # # # . # . . . # . # # # . . # . # .
# # # # # # . . . # . # # # # . # . # .
# . # # # # . . . # . . # # . # . . . .
# . # # # # # . # # # . . # # . # # . #
# # . # . . . # # # . . . # # # . # . .
. # # # . # # . . # . # # . . # . # . .
. # . . . # # . . . . . # . # # # # # #
